NO ../texturs/wall.xpm
SO ../texturs/wall.xpm
WE ../texturs/wall.xpm
EA ../texturs/wall.xpm
F 220,100,0
C 225,30,0
1111111111
100N011111
1111111111