NO ./textures/texture.xpm
SO ./textures/texture.xpm
WE ./textures/texture.xpm
EA ./textures/texture.xpm

F 222,100,0
C 225,30,0

111111111111111111111111111111
11111111111110000000000001
101100000111000000000000001
1000N0100000000000000000111111
11111111011000001110000000000001111111
10000000001100000111011111111111111011
1111011111111101110000001000111111111
11110111111111011101010010001
11000000110101011100000010001
10000000000000001100000010001
10000000000000001101010010001
110000011101010111110111100111
11110111 1110101 101111010001
11111111 1111111 11111 1111111